. . . . . . . . . .
. S . . . . . . . .
. . . . . . . . . .
. . . . . . . . . .
. . . W . W W . . .
. . . W . W W . . .
W W W W W W W . . .
W W W W W . . . . .
. . . . . . . . E .
. . . . . . . . . .